




            NO ./maps_old/textures/64/bluestone.xpm 
SO ./maps_old/textures/64/greystone.xpm
WE ./maps_old/textures/64/purplestone.xpm
EA ./maps_old/textures/64/redbrick.xpm
SP2 ./maps_old/textures/new/yoda512.xpm
SP3 ./maps_old/textures/64/sprite_1.xpm
SP4 ./maps_old/textures/new/yoda.xpm
       FL5 ./maps_old/textures/new/deer512.xpm
DR6 ./maps_old/textures/64/wood.xpm
EX7 ./maps_old/textures/new/startplatinum.xpm          




F 255,0,55
C 0,128,8



 11111111111151111111111
100300000000000000000000511111
1000000000000000000000001000001
1000000000020000W00000006000001
1000000000000000000000001000001
1000000000000000000000005000071
 11111111111151111111111111111


