




NO     ./maps/textures/64/bluestone.xpm 
SO               ./maps/textures/64/greystone.xpm
WE ./maps/textures/64/purplestone.xpm
EA                ./maps/textures/64/redbrick.xpm




F       50,50,50
C 0,0,100




                      1111111
                     100111001
111111111111111111111111111111111111111111
100000000111100000000000000000000000000011
111111111111111111111111111111111111111111
100000000000000000000000000000000000001
100000000000000001000000000000000000001
100011111111111111111111111111111111111111
100010000011000100000000011111111111000001
100010000011000100001110000000111111000001
1000100E000000010001   1000000000111000011
100010000011000100001110000000000000000001
100010000000000000000000000000000000000111
100011111111111111111111111111111111000001
100000000000000000000000000000000000000001
111111111111111111111111111111111111111111