




NO ./maps/textures/64/North.xpm 
EA ./maps/textures/64/East.xpm
WE ./maps/textures/64/West.xpm
SO ./maps/textures/64/South.xpm
SP2 ./maps/textures/new/yoda.xpm
SP3 ./maps/textures/new/dv.xpm
SP4 ./maps/textures/new/crystal.xpm
FL5 ./maps/textures/new/deer512.xpm
DR6 ./maps/textures/new/door.xpm
EX7 ./maps/textures/new/exit.xpm





F 50,75,80
C 140,170,180



 111111111111511111111111111111111111111111
10000000011000000000000000000100000000000007
10004000000000000000000000000500000040000001
10000000000000000000000000000100000000000001
1000000003000000W000000000000100000000000001
10000000000000000000000000000600000040000001
10000000011100000000000000000500000000000001
 111111111111511111111111111111111111111111
