

NO ./maps/textures/64/North.xpm 
EA ./maps/textures/64/East.xpm
WE ./maps/textures/64/West.xpm
SO ./maps/textures/64/South.xpm

F 50,75,80
C 140,170,180

1111111111111111111111111111111111111111111
1000000000000000000000000000000000100000101
1000000000000000000000000000000000001000001
1000111111111111111111111111111111111111111
1000100000000001000000000111111111110000111
1000100000000001000000000111111111110000111
1000100000000001000011100000001111110000111
100010000N000001000100010000000001110000111
1000100000000001000011100000000000000000001
1000100000000000000000000000000000000000111
1000111111111111111111111111111111110000111
1000111111111111111111111111111111110000111
1000000000000000000000000000000000000011111
1000000000000000000000000000000000000110011
1111111011111111111111111111111111111111111
1110000000001111
1110000000001111
1111111111111111     



