

NO ./maps/textures/64/bluestone.xpm 
SO ./maps/textures/64/greystone.xpm
WE ./maps/textures/64/purplestone.xpm
EA ./maps/textures/64/redbrick.xpm
S1 ./maps/textures/64/sprite.xpm
S2 ./maps/textures/64/sprite_1.xpm
S3 ./maps/textures/64/wood.xpm
FL ./maps/textures/new/aer.xpm
DR ./maps/textures/64/redbrick.xpm
EX ./maps/textures/64/redbrick.xpm

F 255,0,55
C 0,128,8

1111111111111111111111111111111111111111111
1000000000000000000000000000000000100000101
1000000000000000000000000000000000001000001
1000111111111111111111111111111111111111111
1000100000000001000000000111111111110000111
1000100000000001000000000111111111110000111
1000100000000001000011100000001111110000111
100010000E000001000100010000000001110000111
1000100000000001000011100000000000000000001
1000100000000000000000000000000000000000111
1000111111111111111111111111111111110000111
1000111111111111111111111111111111110000111
1000000000000000000000000000000000000011111
1000000000000000000000000000000000000110011
1111111111111111111111111111111111111111111


